14 14 14 14 14 14 14 14 14 14 14 14 14 14 14 14 14 14 14 14 14 14 14 14 14 14 14 14 14 14 14 14 14 14 14 14 14 14 14 14 14 14 14 14 14 14 14 14 14 14
14 14 14 14 14 14 14 14 14 14 14 14 14 14 14 14 14 14 14 14 14 17 15 16 14 14 14 15 14 14 14 14 14 14 14 14 14 14 14 14 14 14 14 14 14 14 14 14 14 14
14 14 14 14 14 14 14 14 14 14 14 14 14 14 14 14 14 14 14 14 12 12 12 12 12 12 12 12 12 14 14 14 14 14 17 14 14 16 14 14 14 14 14 14 14 14 14 14 14 14
14 14 14 14 14 14 14 14 14 14 14 14 14 14 14 14 14 14 14 16 12 12 12 12 12 12 12 12 12 14 16 14 14 14 14 17 14 14 14 14 14 14 14 14 14 14 14 14 14 14
14 14 14 14 14 14 14 14 14 14 14 14 14 14 14 14 14 14 14 14 12 12 12 12 12 12 12 12 12 17 14 17 14 14 14 14 14 16 14 14 17 14 14 14 14 14 14 14 14 14
14 14 14 14 14 14 14 15 16 14 14 14 14 14 14 14 15 14 14 14 12 12 12 12 12 12 12 12 12 14 14 14 14 14 16 14 14 14 14 14 14 14 15 14 14 14 14 14 14 14
14 14 14 14 14 14 14 14 14 14 14 17 14 14 14 14 14 14 16 14 14 14 11 13 10 12 10 14 14 14 14 14 15 15 14 10 13 12 11 10 10 16 14 16 14 14 14 14 14 14
14 14 14 14 14 14 11 11 11 11 11 11 11 11 11 14 14 14 14 17 15 16 14 10 10 13 10 11 10 14 14 14 14 15 14 11 10 10 11 10 10 14 15 14 17 14 14 14 14 14
14 14 14 14 14 14 11 13 13 13 13 13 13 13 11 14 14 14 14 14 14 14 15 19 14 16 15 17 14 15 14 15 14 14 14 12 10 11 11 10 13 14 15 14 14 14 14 14 14 14
14 14 14 14 14 14 11 13 13 13 13 13 13 13 11 14 14 16 17 14 17 16 14 18 17 14 17 14 17 14 14 14 14 17 14 14 13 11 10 11 10 12 14 14 14 14 14 14 14 14
14 14 14 14 14 14 11 13 13 13 13 13 13 13 11 14 15 14 16 14 17 14 17 18 15 14 14 17 14 15 14 14 14 14 15 14 10 12 12 11 10 11 14 14 17 14 17 14 14 14
14 14 14 14 14 15 11 13 13 13 13 13 13 13 11 14 14 15 14 17 14 17 14 18 14 15 14 14 14 14 15 15 14 14 14 14 10 13 13 11 10 11 17 14 16 14 14 14 14 14
14 14 14 14 14 14 11 11 11 11 10 11 11 11 11 14 15 14 15 16 17 17 15 18 16 14 14 17 16 14 14 14 14 16 14 16 11 10 10 12 13 10 14 14 14 14 14 14 14 14
14 14 14 14 14 14 14 14 14 17 10 14 14 14 14 15 14 14 17 14 14 15 14 18 17 17 15 14 14 15 17 14 14 14 16 14 14 14 14 18 14 14 14 14 14 17 17 14 14 14
14 14 14 14 14 14 14 16 14 14 10 14 14 16 14 14 16 14 14 17 14 14 15 18 14 14 15 14 14 14 15 14 15 14 15 14 17 14 14 18 14 14 14 14 14 14 14 14 14 14
14 14 14 14 14 14 14 14 15 14 10 14 14 14 17 14 15 14 17 14 15 15 17 18 17 14 16 14 17 17 14 15 14 14 15 14 14 14 14 18 16 14 14 15 14 14 17 14 14 14
14 14 14 14 14 14 14 17 14 14 10 16 14 15 14 17 15 14 14 17 17 14 17 18 15 14 14 16 15 14 14 14 15 17 14 14 15 14 14 18 14 14 14 17 14 17 14 14 14 14
14 14 14 14 14 14 14 17 14 14 10 14 14 14 14 14 14 15 14 15 14 16 15 18 14 17 15 14 14 15 14 14 15 17 14 14 14 17 14 18 14 14 17 14 14 14 14 14 14 14
14 14 14 14 14 14 14 14 15 14 10 14 14 14 16 14 16 14 14 14 16 14 10 18 12 14 14 15 14 15 14 17 14 14 17 14 14 16 14 18 14 15 14 14 14 14 14 14 14 14
14 14 14 14 14 14 14 14 14 16 10 14 14 16 14 14 15 17 14 15 14 11 12 18 10 12 14 14 16 16 17 17 14 15 14 14 14 14 17 18 14 14 15 14 14 14 14 14 14 14
14 14 14 14 14 14 14 14 14 17 10 14 14 14 14 14 14 15 17 14 10 13 10 18 11 13 10 17 14 17 14 14 14 14 15 14 14 15 14 18 14 14 14 16 14 14 14 14 14 14
14 14 14 14 14 14 17 14 14 14 10 19 19 19 19 19 19 19 19 19 19 19 19 19 19 19 19 19 19 19 19 19 19 19 19 19 19 19 19 19 14 17 14 14 14 14 14 14 14 14
14 14 14 14 14 14 14 14 14 14 10 14 14 14 16 14 15 14 17 14 13 10 12 18 13 12 12 15 17 14 17 17 17 15 14 14 15 16 14 18 14 14 16 14 14 14 14 14 14 14
14 14 14 14 14 14 14 14 10 13 10 10 10 12 10 14 14 15 14 16 17 10 11 18 10 11 15 17 14 15 16 14 15 14 15 15 14 14 17 18 14 14 14 14 14 14 14 14 14 14
14 14 14 14 14 14 14 16 10 10 10 10 11 10 10 16 16 14 16 14 15 16 10 18 13 17 15 16 15 14 15 17 14 14 17 14 15 14 14 18 16 14 14 14 14 14 14 14 14 14
14 14 14 14 14 14 14 14 11 10 10 10 10 10 12 14 14 15 16 15 17 14 17 18 15 17 17 14 14 17 14 14 14 15 17 14 17 14 14 18 14 14 14 14 14 14 14 14 14 14
14 14 14 14 14 14 14 14 10 10 13 13 10 12 10 14 15 14 16 16 14 17 14 18 15 15 14 14 17 14 14 14 17 17 14 14 14 15 14 18 14 14 14 15 14 14 14 14 14 14
14 14 14 14 14 14 15 15 10 14 14 14 14 15 14 14 14 17 17 14 17 16 15 18 14 14 15 17 15 14 15 14 14 14 15 15 14 15 14 18 14 14 14 14 14 14 14 14 14 14
14 14 14 14 14 14 14 14 10 14 14 17 14 14 14 17 14 14 15 16 14 14 14 18 14 14 15 17 14 14 15 16 14 14 15 14 15 14 15 18 14 17 14 14 14 14 14 14 14 14
14 14 14 14 14 14 14 14 10 14 14 14 14 14 17 14 14 16 14 14 14 16 14 18 13 15 14 14 16 14 14 14 17 14 14 14 15 14 14 18 14 14 14 14 14 14 14 14 14 14
14 14 14 14 14 14 16 14 10 14 14 16 14 14 14 17 16 14 14 14 15 14 14 18 13 14 14 15 14 16 14 14 14 14 14 15 14 16 14 18 14 15 14 14 14 14 14 14 14 14
14 14 14 14 14 14 14 17 10 14 14 14 17 15 14 14 14 17 14 15 14 14 14 18 13 14 14 17 14 14 14 14 14 16 14 14 14 14 14 18 14 14 14 14 14 14 14 14 14 14
14 14 14 14 14 14 14 14 10 14 14 16 14 14 14 14 14 14 15 16 17 14 14 18 14 14 14 14 14 14 14 16 14 14 17 14 14 14 17 10 14 16 14 14 14 14 14 14 14 14
14 14 14 14 14 14 14 14 10 14 14 14 14 14 17 14 14 14 10 10 12 10 10 10 13 13 10 10 14 14 17 14 14 14 14 15 14 14 12 10 14 17 14 14 14 14 14 14 14 14
14 14 14 14 14 14 14 14 10 14 14 14 14 14 14 14 14 14 11 10 12 10 10 10 10 10 11 10 10 10 10 10 10 10 10 10 10 10 10 10 14 14 15 14 14 14 14 14 14 14
14 14 14 14 14 14 14 14 10 13 13 13 13 13 13 13 14 16 10 10 10 10 10 10 10 10 10 10 15 14 14 14 14 14 17 14 16 14 14 10 14 14 14 14 14 14 14 14 14 14
14 14 14 14 14 14 14 14 14 13 13 13 13 13 13 13 14 14 10 10 12 10 10 10 10 12 10 10 14 14 16 14 16 14 15 14 14 14 14 10 15 14 16 14 14 14 14 14 14 14
14 14 14 14 14 14 14 16 14 13 13 13 13 13 13 13 15 14 10 10 10 10 11 13 10 10 10 10 14 14 14 14 14 15 14 17 10 12 10 10 14 16 14 17 14 14 14 14 14 14
14 14 14 14 14 14 14 14 14 15 14 14 15 14 14 17 14 14 10 13 10 10 10 10 10 10 10 13 15 14 14 14 14 14 14 14 11 10 10 10 14 14 14 14 14 14 14 14 14 14
14 14 14 14 14 14 14 14 14 14 14 17 14 14 14 16 14 17 10 10 12 10 11 10 12 10 11 10 14 16 14 14 14 14 14 15 10 13 13 10 17 14 14 14 14 14 14 14 14 14
14 14 14 14 14 14 14 14 14 14 14 14 14 14 14 14 14 14 10 10 10 10 10 10 10 10 10 14 16 14 14 15 14 14 16 14 14 10 14 10 14 14 14 14 14 14 14 14 14 14
14 14 14 14 14 14 14 14 14 14 14 14 14 14 14 14 14 17 14 15 14 14 14 14 14 17 14 14 14 14 17 14 16 14 14 14 17 10 14 10 14 14 14 14 14 14 14 14 14 14
14 14 14 14 14 14 14 14 14 14 14 14 14 15 14 14 14 14 14 15 14 14 16 14 14 14 15 14 14 16 14 14 17 14 14 14 14 10 10 10 14 15 14 14 14 14 14 14 14 14
14 14 14 14 14 14 14 14 14 14 14 14 14 14 16 14 14 14 14 14 14 16 14 14 14 14 14 14 14 14 14 14 14 14 15 14 14 10 12 10 14 14 14 14 14 14 14 14 14 14
14 14 14 14 14 14 14 14 14 14 14 14 14 14 14 14 17 14 14 14 14 14 14 14 14 14 14 14 14 15 14 14 16 14 14 14 16 14 14 14 15 14 14 14 14 14 14 14 14 14
14 14 14 14 14 14 14 14 14 14 14 14 14 14 14 14 14 14 14 15 14 14 14 14 14 14 17 14 14 14 14 14 14 14 14 17 14 14 17 14 14 14 14 14 14 14 14 14 14 14
14 14 14 14 14 14 14 14 14 14 14 14 14 14 14 14 14 14 14 14 14 16 14 14 14 14 14 14 14 14 14 14 14 14 14 14 14 14 14 14 14 14 14 14 14 14 14 14 14 14
14 14 14 14 14 14 14 14 14 14 14 14 14 14 14 14 14 14 14 14 14 14 14 14 14 14 14 14 14 14 14 14 14 14 14 14 14 14 14 14 14 14 14 14 14 14 14 14 14 14
14 14 14 14 14 14 14 14 14 14 14 14 14 14 14 14 14 14 14 14 14 14 14 14 14 14 14 14 14 14 14 14 14 14 14 14 14 14 14 14 14 14 14 14 14 14 14 14 14 14
14 14 14 14 14 14 14 14 14 14 14 14 14 14 14 14 14 14 14 14 14 14 14 14 14 14 14 14 14 14 14 14 14 14 14 14 14 14 14 14 14 14 14 14 14 14 14 14 14 14








